111111111111111111111111111111111111111
100000000000000000000000000000000000001
100000100010111101111000000000000000001
100000100010100001000000000000000000001
100000111110111001000000000000000000001
100000100010111101111000000000000000001
100000000000000000000000000000000000001
100000000000000000000000000000000000001
100000000000000000000000000000000000001
100000000000000000000000000000000000001
100000000000000000000000000000000000001
100000000000000000000000000000000000001
100000000000000000000000000000000000001
111111111111111111111111111111111111111




