111111111111111111111111111111111111111
100000000000000000000000000000000000001
100000100010000000000000000000000000000
100000100010000000000000000000000000001
100000111110000000000000000000000000001
100000100010000000000000000000000000001
100000000000000000000000000000000000001
100000000000000000000000000000000000001
111111111111111111111111111111111111111