11111111111111111111111111
1000000000100000010CC00001
10000010101000000111111101
1000001C101101100000000001
10E00011100000100000000001
1000001C111110111111C11111
10000010100C10100000000001
10P00010100010100000000001
1000001000C0CC10C000000001
11111111111111111111111111
